1111111111111111111111111
1000000000000M00100100CM1
1110000P00000C11100001111
1C00011M0000000C0000C0111
111000000M00000C111100111
110000010001101000C000011
1110000000000000000000111
111000M000C111100C0001E11
11111100000111100000M1011
1C00000000000M0C000000C11
1111111111111111111111111