11111111
100M0E01
1P00CC01
11111111