111111111111111111111111
10C0000C00000C0000000011
10000C0000C00000C0000011
10C00000P000C000000C0011
10000C00000C000000000011
10C0000C00000000C0000011
10000CE00000C0000000C011
10C000000C00000C00000011
111111111111111111111111