1111111
10000E1
1P00C01
1111111