111111111111111111111111
10C0000C00M00C0000000M11
10000C0000C00000C0000011
10C00M00P000C0000M0C0011
10000C00000C000000000011
10C00MMC00000000C0000011
10000CEM0000C0000000C011
10C00MM00C000M0C00000011
111111111111111111111111