1111111
1000001
1000P01
1MM0001
1EM0C11
1111111