1111111
1000001
1000P01
1000001
1E30C11
1111111