1111111
1000001
1000P01
1000001
1E00011
1111111