2222222
3000P03
4E0C004
1111111