1111111
1000001
1000P01
1110001
1E10C11
1111111