1111111
1000001
10P011
1000001
1EE0C11
1111111