1111111
1000001
1000001
1000001
1E0C111
1111111