1111111
1000001
1000P01
1011111
1E00C11
1111111