1111111
1001111
1001P11
1001101
1E00C11
1111111