1111111
1001000
1000P01
1000001
1E00C11
1111111