1111111
1000001
1000P01
1000001
1EE0C11
1111111