11111111
100C1E01
1P00CC01
11111111