1111111111111111111111111
1000000000000000100100CM1
1110000P00000C11100001111
1C0001100000000C0000C0111
111000000000000C111100111
110000010001101000C000011
1110000000000000000000111
1110000000C111100C0001E11
1111110000011110000001011
1C0000000000000C000000C11
1111111111111111111111111