11111111
10000E01
1P00CC01
11111111