11111111
100C0E01
1P00CC01
11111111