11111111
10000E01
1P00C001
11111111